NO ./textures/n.xpm
SO ./textures/s.xpm
EA ./textures/e.xpm
WE ./textures/w.xpm

F 255,0,0
C 0,0,255

		1111111111111111111111111
		1S00000000110000000000001
		1011000001110000000000001
		1001000000000000000000001
111111111011000001110000000000001
100000000011000001110111111111111
11110111111111011100000010001
11110111111111011101010010001
11000000110101011100000010001
10000000000000001100000000001
10000000000000001101010010001
1100000111010101111101111000011
11110101 1010101 101111010001 
11111111 1111111 111111111111
