NO ./textures/n.xpm
SO ./textures/s.xpm
EA ./textures/e.xpm
WE ./textures/w.xpm

F 255,0,0
C 0,0,255


     111
     101
     101
     101
     101
1111110111111
100000E000001
1111110111111
     101
     101
     101
     101
     111
