NO ./textures/map03/N.xpm
SO ./textures/map03/S.xpm
EA ./textures/map03/E.xpm
WE ./textures/map03/W.xpm

F 62,110,61
C 77,182,231


1111111
1000001
100S001
1000001
1110111
10000011111
11000110001
11101111101
1110111 101
1110001 101
1001101 101
1001101 101
10100011101
10000000001
11111111111