NO ./textures/map01/N.xpm
SO ./textures/map01/S.xpm
EA ./textures/map01/E.xpm
WE ./textures/map01/W.xpm

F 160, 108, 48
C 88,149,197

11111111111111111111111111111
11111111000000000010000010001
10000000001111110010101010101
10000111001100000010101010101
11000111000111110010101010101
1110011100010N010010101010101
11110111001111010010101010101
11110111000001010010101010101
11110111001100000010101010101
10000111001111110000101000101
11111111111111111111111111111